0,0,0,0,0,0,0,0,0,0,0,0,0,0,0,0,0,0,0,4604,0,0,0,0,0,0,0,0,0,0,0,0,0,0,0,0,0,0,0,0,902,902,4255,4255,4255,4255,4255,4255,4255,4255,4255,4255,4255,4255,4255,4255,4255,4255,4255,4255,4252,4252,4252,4252,4252,4252,4252,4252,4252,4252,4252,4252,4252,4252,4252,4252,4252,4252,4252,4252,
0,0,4255,4255,4255,0,4255,4255,0,4255,4255,0,4255,4255,4255,0,4255,0,0,4604,4256,4256,4256,4256,4256,4256,4256,4206,4206,4206,4256,4206,4206,4206,4256,4256,4256,4256,4256,4256,4255,0,0,0,0,0,0,0,0,0,0,0,0,0,0,0,0,0,0,0,0,0,0,0,0,0,0,0,0,0,0,0,0,0,0,0,0,0,0,4252,
0,0,0,4255,0,0,4255,0,0,4255,0,0,0,4255,0,0,0,0,0,4604,4256,4256,0,0,0,0,4256,4256,4256,4256,4256,4256,4256,4256,4256,0,0,0,0,4256,4255,4255,4255,4255,4255,4255,4255,4255,4255,4255,4255,4255,4255,4255,4255,4255,4255,4255,4255,4255,4252,0,0,0,0,0,0,0,0,0,0,0,0,0,0,0,0,0,4252,4252,
0,0,0,4255,0,0,4255,4255,0,4255,4255,0,0,4255,0,0,4255,0,0,4604,4256,4256,4903,4903,4903,4903,4903,4256,4256,4256,4605,4256,4256,4256,4903,4903,4903,4903,4903,4256,4255,4255,4255,4255,4255,4255,4255,4255,4255,4255,4255,4255,4255,4255,4255,4255,4255,4255,4255,4255,4252,4252,0,0,0,0,0,0,0,0,0,0,0,0,0,0,0,4252,4252,4252,
0,0,0,4255,0,0,4255,0,0,0,4255,0,0,4255,0,0,4255,0,0,4604,4256,4256,0,0,0,0,0,0,4256,4256,4605,4256,4256,0,0,0,0,0,0,4256,4255,0,0,0,0,0,0,0,0,0,0,0,0,0,0,0,0,0,0,4255,4252,4252,4252,0,0,0,0,0,0,0,0,0,0,0,0,0,4252,4252,4252,4252,
0,0,0,4255,0,0,6584,4853,4856,4857,2583,0,0,4255,0,0,4255,0,0,4604,4256,4256,0,0,0,0,0,0,0,4256,4605,4256,0,0,0,0,0,0,0,4256,4255,0,0,0,0,0,0,0,0,0,0,0,0,0,0,0,0,0,0,4255,4252,4252,4252,4252,0,0,0,0,0,0,0,0,0,0,0,4252,4252,4252,4252,4252,
0,0,0,0,0,0,0,0,0,0,0,0,0,0,605,0,604,604,604,4604,4256,4256,0,0,0,0,0,0,0,4903,4605,4903,0,0,0,0,0,0,0,4256,4255,0,0,0,0,0,0,0,0,0,0,0,0,0,0,0,0,0,0,4255,4252,4252,4252,4252,4252,0,0,0,0,0,0,0,0,0,4252,4252,4252,4252,4252,4252,
0,0,0,4604,4759,4759,4759,4759,4759,4759,4759,4759,4759,4759,605,0,604,604,604,4604,4256,4256,0,0,0,0,0,0,0,4903,4605,4903,0,0,0,0,0,0,0,4256,4255,0,0,0,0,0,0,0,0,0,0,0,0,0,0,0,0,0,0,4255,4252,4252,4252,4252,4252,4252,0,0,0,0,0,0,0,4252,4252,4252,4252,4252,4252,4252,
0,0,0,4604,5303,4605,4903,0,4906,0,0,4907,604,5303,605,0,0,0,0,4604,4256,4256,0,0,0,0,0,0,0,4256,4605,4256,0,0,0,0,0,0,0,4256,4255,0,0,0,0,0,0,0,0,0,0,0,0,0,0,0,0,0,0,4255,4252,4252,4252,4252,4252,4252,4252,4252,4252,4252,4604,4252,4252,4252,4252,4252,4252,4252,4252,4252,
401,402,403,4604,5353,4605,0,0,0,0,0,0,604,5353,605,4401,4402,4403,0,4604,4256,4256,0,0,0,0,0,0,4256,4256,4605,4256,4256,0,0,0,0,0,0,4256,4255,0,0,0,0,0,0,0,4907,4907,4907,4907,4907,0,0,0,0,0,0,4255,4252,4252,4252,4252,4252,4252,4252,4252,4252,0,4604,0,4252,4252,4252,4252,4252,4252,4252,4252,
451,452,453,4604,5403,4605,5853,0,5853,0,4508,5853,604,5403,605,4451,4452,4453,0,4604,4256,4256,4903,4903,4903,4903,4903,4256,4256,4256,4605,4256,4256,4256,4903,4903,4903,4903,4903,4256,4255,0,0,0,0,0,0,0,4907,0,4604,0,4907,0,0,0,0,0,0,4255,4252,4252,4252,4252,4252,4252,4252,4252,4252,0,4604,0,4252,4252,4252,4252,4252,4252,4252,4252,
4003,4004,4005,4006,4007,4008,4002,4003,4004,4005,4006,4007,4008,4002,4003,4004,4005,4006,4007,4008,4256,4256,0,0,0,0,0,0,0,4906,4605,4256,4256,4256,0,0,0,0,0,4256,4255,0,0,0,0,0,0,0,4907,0,4604,0,4907,0,0,0,0,0,0,4255,4252,4252,4252,4252,4252,4252,4252,4252,4252,0,4604,0,4252,4252,4252,4252,4252,4252,4252,4252,
253,253,253,253,253,253,253,253,253,253,253,253,253,253,253,253,253,253,253,253,4256,4256,4256,4256,4256,4256,4256,4256,4256,4256,4605,4256,4256,4256,4256,4256,4256,4256,4256,4256,4255,4255,4255,4255,4255,4255,4255,4255,4255,4255,4604,4255,4255,4255,4255,4255,4255,4255,4255,4255,4252,4252,4252,4252,4252,4252,4252,4252,4252,4252,4604,4252,4252,4252,4252,4252,4252,4252,4252,4252,
253,0,0,0,0,0,0,0,0,0,0,0,0,0,0,0,0,0,0,0,4256,0,0,0,0,0,4256,4256,4256,0,4605,0,4256,4256,4256,0,0,0,4256,0,4255,0,0,0,0,0,0,0,0,0,4604,0,0,0,0,0,0,0,0,0,4252,0,0,0,4605,4252,4605,0,0,0,4604,4252,0,252,0,0,4252,4252,4252,4252,
253,0,0,0,0,0,0,0,0,0,0,0,0,0,0,0,0,0,0,0,0,0,0,0,0,0,0,0,0,0,0,0,0,0,0,0,0,0,0,0,0,0,0,0,0,0,0,0,0,0,4604,0,0,0,0,0,0,0,4907,0,0,0,0,0,4605,4252,4605,0,0,0,4604,4252,6584,4906,0,0,0,4252,4252,4252,
253,4604,203,203,203,203,203,203,203,203,203,203,203,203,203,203,203,203,203,203,4256,4256,4256,4256,4256,4256,4256,4256,4256,4903,759,4903,4256,4256,4256,4256,4604,4256,4256,4256,4205,4205,4907,4907,4907,4604,4205,4205,4205,0,4604,0,4205,4205,4205,4907,4907,4205,4604,4255,4202,4202,4202,0,4605,4252,4605,4252,4252,4252,4604,4252,4252,4252,0,0,0,0,4252,4252,
253,4604,0,253,253,253,253,253,253,253,253,253,253,253,253,253,253,253,253,253,4256,0,0,0,0,0,4256,0,0,0,4604,0,0,4256,0,0,4604,4256,4256,4256,4255,4255,4255,0,0,4604,0,4255,4255,4255,4255,4255,4255,4255,0,0,0,4255,4604,4255,4252,4605,0,0,4605,4252,4605,4252,0,0,4604,4252,4252,4252,4252,0,0,0,0,4252,
253,0,0,0,0,253,253,253,253,253,253,253,253,253,253,253,253,253,253,253,4256,0,0,0,0,0,4256,0,0,0,0,0,0,4256,0,0,4604,4256,4256,4256,4255,4255,4255,4255,0,0,0,0,4255,5853,4255,5853,4255,0,0,0,0,4255,4604,4255,4252,4605,0,0,4605,4252,4605,4252,0,0,4252,0,0,0,0,0,0,0,0,4252,
253,203,203,0,0,253,253,253,253,253,253,253,253,253,253,253,253,253,253,253,4256,0,4604,4256,4256,4256,4256,0,0,759,759,759,0,4256,0,0,4604,4256,4256,4256,4255,4255,4255,4255,4255,0,0,0,4255,4255,4255,4255,4255,0,0,0,4255,4255,4604,4255,4252,4605,0,0,4605,4252,4605,4252,0,0,0,0,4252,4252,4604,4252,4252,4252,4252,4252,
253,0,0,0,0,253,253,253,253,253,253,253,253,253,253,253,253,253,253,253,4256,4256,4604,0,4256,0,0,0,0,0,0,0,0,0,0,0,4604,4256,4256,4256,4255,4255,4255,4255,4255,4255,0,0,0,0,0,0,0,0,0,0,4255,4255,4604,4255,4252,4605,0,0,4252,4252,0,4252,4252,4252,4252,4252,0,0,4604,0,0,0,0,4252,
253,0,0,203,203,253,253,253,253,253,253,253,253,253,253,253,253,253,253,253,4256,4256,4604,0,0,0,0,4256,4256,4256,4256,4256,4256,4256,4256,4256,4256,4256,4256,4256,4255,4255,4255,4255,4255,4255,4255,0,0,0,0,0,0,0,0,4255,4255,4255,4604,4255,4252,4605,0,4252,4252,0,0,0,0,0,0,0,0,0,4604,0,0,0,0,4252,
253,0,203,253,253,253,253,253,253,253,253,253,253,253,253,253,253,253,253,253,4256,4256,4604,0,0,0,4256,0,0,0,0,0,0,0,0,4256,4256,4256,4256,4256,4255,4255,4255,4255,4255,4255,4255,4255,4255,4255,4255,4255,4255,4255,4255,0,0,0,4604,4255,4252,4605,0,0,0,0,0,0,0,0,0,0,0,0,4252,4103,4103,4103,4604,4252,
253,0,0,0,0,0,0,0,0,0,0,0,0,0,0,0,0,0,4604,253,4256,4256,4604,0,0,4256,5851,5852,5853,5853,5853,5853,5853,5853,5852,5851,4256,4256,4256,4256,4255,4255,4255,4255,4255,4255,4255,4255,5853,0,0,0,5853,4255,4255,0,0,0,4604,4255,4252,4605,0,0,0,0,0,0,0,6153,0,0,0,0,0,0,0,0,4604,4252,
253,203,203,203,203,203,203,203,203,203,203,203,203,203,203,203,203,203,604,253,4251,4251,4251,4251,4251,4251,4251,4251,4251,4251,4251,4251,4251,4251,4251,4251,4251,4251,4251,4251,4255,4255,4255,4255,4255,4255,4255,4255,4255,4255,4255,4255,4255,4255,4255,4255,4255,4255,4255,4255,4252,4252,4252,4252,4252,4252,4252,4252,4252,4252,4252,4252,4252,4252,4252,4252,4252,4252,4252,4252,
253,253,253,253,253,253,253,253,253,253,253,253,253,253,253,253,253,253,604,253,251,0,0,0,0,0,0,0,0,0,0,0,0,0,0,0,0,0,0,251,255,0,0,0,0,0,0,0,0,0,0,0,0,0,0,0,0,0,0,255,252,4252,4252,4252,4252,4252,4252,4252,4252,4252,4252,4252,4252,4252,4252,4252,4252,4252,4252,252,
253,253,253,253,253,253,253,253,253,253,253,253,253,253,253,253,253,253,604,253,251,0,0,0,0,0,0,0,0,0,0,0,0,0,0,0,0,0,0,251,255,0,0,0,0,0,0,0,0,0,0,0,0,0,0,0,0,0,0,255,252,0,0,0,0,0,0,0,604,0,0,0,0,0,0,0,0,0,604,252,
253,253,253,253,253,253,253,253,253,253,253,253,253,253,253,253,253,253,604,253,251,0,0,0,0,0,0,0,0,0,0,0,0,0,0,0,0,0,0,251,255,255,255,0,0,0,0,0,0,0,0,0,0,0,0,0,0,0,0,0,902,0,252,252,252,0,0,0,604,0,252,605,4252,605,605,4252,4252,4252,604,252,
253,253,253,253,253,253,253,253,253,253,253,253,253,253,253,253,253,253,604,253,251,0,0,0,0,0,0,0,0,604,0,0,0,0,0,0,0,0,0,251,255,2583,4907,0,0,0,0,0,0,0,0,0,0,0,0,0,0,0,0,0,902,252,605,0,605,252,252,252,604,252,605,605,0,605,605,0,0,0,604,252,
253,253,253,253,253,253,253,253,253,253,253,253,253,253,253,253,253,253,604,253,251,0,0,0,201,201,201,201,201,604,201,201,201,201,201,0,0,0,0,251,255,205,205,205,205,205,205,205,205,205,205,205,205,205,205,205,205,205,205,205,202,0,605,0,605,604,0,0,604,605,605,605,0,605,4252,0,0,0,604,252,
253,253,253,253,253,253,253,253,253,253,253,253,253,253,253,253,253,253,604,253,251,0,0,0,605,0,0,0,251,604,251,0,0,0,605,0,0,0,0,251,0,0,0,0,0,0,0,0,0,0,0,0,0,0,0,0,0,0,0,0,252,0,605,0,605,604,0,0,604,605,605,605,0,605,0,0,0,0,604,252,
253,253,253,253,253,253,253,253,253,253,253,253,253,253,253,253,253,253,604,253,251,0,0,0,605,0,0,0,251,604,251,0,0,0,605,0,0,0,0,251,0,0,0,0,0,0,0,0,0,0,0,0,0,0,0,0,0,0,0,0,252,0,605,604,605,604,0,0,604,605,605,605,0,605,0,0,0,0,604,252,
253,253,253,253,253,253,253,253,253,253,253,253,253,253,253,253,253,253,604,253,251,0,0,0,605,0,0,0,251,604,251,0,0,0,605,0,0,0,0,251,255,255,255,255,255,255,255,255,255,255,255,255,255,255,255,255,255,255,255,255,252,0,605,604,605,4604,0,0,604,252,605,605,252,605,0,0,0,0,604,252,
253,253,253,253,253,253,253,253,253,253,253,253,253,253,253,253,253,253,604,253,251,0,0,0,605,0,0,0,251,604,251,0,0,0,605,0,0,0,0,251,255,255,255,255,255,255,255,255,255,255,255,255,255,255,255,255,255,255,255,255,252,604,605,604,605,4604,0,0,604,252,605,605,252,605,0,0,0,0,604,252,
253,253,253,253,253,253,253,253,253,253,253,253,253,253,253,253,253,253,604,253,251,0,0,0,605,0,0,0,0,604,0,0,0,0,605,0,0,0,0,251,255,255,255,255,255,255,255,255,255,255,255,255,255,255,255,255,255,255,255,255,252,604,0,252,605,4604,0,0,604,252,605,605,252,605,0,0,0,0,604,252,
253,253,253,253,253,253,253,253,253,253,253,253,253,253,253,253,253,253,604,253,251,0,0,0,605,0,0,0,251,604,251,0,0,0,605,0,0,0,0,251,255,255,255,255,255,255,255,255,255,255,255,255,255,255,255,255,255,255,255,255,252,604,0,252,605,4604,0,0,604,605,605,605,0,605,0,0,0,0,604,252,
253,253,253,253,253,253,253,253,253,253,253,253,253,253,253,253,253,253,604,253,251,251,251,251,251,251,251,251,251,604,251,251,251,251,251,251,251,251,251,251,255,255,255,255,255,255,255,255,255,255,255,255,255,255,255,255,255,255,255,255,252,604,4252,252,605,4252,4604,252,604,605,605,605,0,605,252,252,0,0,604,252,
253,253,253,253,253,253,253,253,253,253,253,253,253,253,253,253,253,253,604,253,251,251,251,251,251,251,251,251,251,604,251,251,251,251,251,251,251,251,251,251,255,255,255,255,255,255,255,255,255,255,255,255,255,255,255,255,255,255,255,255,252,604,0,252,605,0,4604,252,604,605,605,0,0,605,605,0,0,0,604,252,
253,253,253,253,253,253,253,253,253,253,253,253,253,253,253,253,253,253,604,253,251,0,0,0,0,0,0,0,0,604,0,0,0,0,0,0,0,0,0,251,255,255,255,255,255,255,255,255,255,255,255,255,255,255,255,255,255,255,255,255,252,604,902,252,605,0,4604,252,604,605,605,0,0,0,605,0,0,0,604,252,
253,604,0,0,0,0,0,0,0,0,0,0,0,0,0,0,0,0,604,0,0,0,0,0,0,0,0,0,0,4604,0,0,0,0,0,0,0,0,0,0,0,0,0,0,0,0,0,0,0,0,0,0,0,0,0,0,0,0,0,0,0,4604,4604,252,605,0,604,252,604,605,605,0,0,0,605,0,0,0,604,252,
253,604,253,253,253,253,253,253,253,253,253,253,253,253,253,253,253,253,253,253,201,604,201,4907,201,201,4907,201,4907,201,4907,201,4907,201,604,201,4907,201,4907,201,205,205,205,205,205,205,205,205,205,205,205,205,205,205,205,205,205,205,205,205,202,202,4604,252,605,252,604,252,604,605,605,0,0,0,605,0,0,0,604,252,
253,4604,0,0,0,0,0,0,0,0,0,0,0,0,0,0,0,0,0,253,251,604,0,0,251,0,0,0,0,0,0,0,251,0,604,0,0,0,0,251,0,0,0,0,0,0,0,0,0,0,0,0,0,0,0,0,0,0,0,0,252,0,604,252,4605,252,604,252,604,605,605,0,0,0,605,0,0,0,604,252,
253,253,253,253,253,253,253,253,253,253,253,253,253,253,253,253,253,253,604,253,251,604,0,0,0,0,0,0,0,0,0,251,0,0,604,0,0,0,0,251,0,0,0,0,0,0,0,0,0,0,0,0,0,0,0,0,0,0,0,0,252,0,604,252,4605,252,604,252,604,605,605,0,0,0,605,0,0,0,604,252,
253,604,0,0,0,0,0,0,0,0,0,0,0,0,0,0,0,0,604,253,251,604,0,0,0,251,0,251,0,0,0,0,0,0,604,0,251,0,0,251,0,0,0,0,0,0,0,0,0,0,0,0,0,0,0,0,0,0,0,0,252,0,604,252,4605,252,252,252,604,605,605,0,0,0,605,0,0,0,604,252,
253,604,253,253,253,253,253,253,253,253,253,253,253,253,253,253,253,253,253,253,251,604,0,0,0,0,0,0,0,0,0,0,251,0,604,0,0,0,0,251,403,403,403,403,403,403,403,403,403,403,403,403,403,403,403,403,403,403,403,403,252,0,604,0,4605,0,0,252,604,605,605,0,0,0,605,0,0,0,604,252,
253,604,0,0,0,0,0,0,0,0,0,0,0,253,0,0,0,0,0,253,251,604,0,0,0,0,0,0,251,0,0,0,0,251,604,0,0,0,0,251,403,403,403,403,403,403,403,403,403,403,403,403,403,403,403,403,403,403,403,403,252,0,604,252,252,252,252,252,604,4252,605,0,0,0,605,0,0,0,604,252,
253,4253,253,253,253,253,253,253,253,4253,4253,4253,253,253,0,0,0,0,0,253,251,604,251,0,0,0,0,0,0,251,251,0,0,0,604,0,0,0,0,251,403,403,403,403,403,403,403,403,403,403,403,403,403,403,403,403,403,403,403,403,252,0,604,0,0,0,0,0,604,4252,605,0,0,0,0,0,0,0,604,252,
253,401,401,401,401,401,401,401,401,401,401,401,401,401,401,401,401,401,401,253,251,604,0,0,0,0,251,402,402,402,251,251,251,251,251,0,0,0,0,251,453,453,453,453,453,453,453,453,453,453,453,453,453,453,453,453,453,453,453,453,252,0,4604,0,0,0,0,0,604,4252,605,0,0,0,0,0,0,0,604,252,
253,451,451,451,451,451,451,451,451,451,451,451,451,451,451,451,451,451,451,253,251,251,251,251,251,251,452,452,452,452,452,452,251,251,251,251,251,251,251,251,453,453,453,453,453,453,453,453,453,453,453,453,453,453,453,453,453,453,453,453,252,252,252,252,252,252,252,402,604,402,252,252,252,252,252,252,252,252,252,252,
253,253,253,253,253,253,253,253,253,253,253,253,253,253,253,253,253,253,253,253,251,251,251,251,251,251,251,251,251,251,251,251,251,251,251,251,251,251,251,251,255,255,255,255,255,255,255,255,255,255,255,255,255,255,255,255,255,255,255,255,252,0,0,0,0,0,0,0,604,0,0,0,0,0,0,0,0,0,0,2327,
253,253,4508,253,253,253,253,253,253,253,253,253,253,253,253,253,253,253,253,253,251,251,251,251,251,251,251,251,251,251,251,251,251,251,251,251,251,251,251,251,255,0,0,0,0,0,0,0,0,0,0,0,0,0,0,0,0,0,0,255,252,0,0,0,0,0,0,0,604,0,0,0,0,0,0,0,0,0,0,252,
253,253,2328,253,253,253,253,253,253,253,253,253,253,253,253,253,253,253,253,253,251,0,0,0,0,0,0,0,0,0,0,0,0,0,0,0,0,0,0,251,255,0,0,0,0,0,0,0,0,0,0,0,0,0,0,0,0,0,0,255,252,0,0,0,0,0,0,0,604,0,0,0,0,0,0,0,0,0,252,252,
253,4604,4604,0,906,0,0,0,0,0,0,0,0,0,0,0,0,0,0,253,251,0,0,0,0,0,0,0,0,0,0,0,0,0,0,0,0,0,0,251,255,0,0,0,0,0,0,0,0,0,0,0,0,0,0,0,0,0,0,255,252,0,0,0,0,0,0,0,604,0,0,0,0,0,0,0,0,252,252,252,
253,4604,4604,0,906,0,0,0,0,0,0,0,0,0,0,0,0,0,0,253,251,0,0,0,0,0,0,0,0,0,0,0,0,0,0,0,0,0,0,251,255,0,0,0,0,0,0,0,0,0,0,0,0,0,0,0,0,0,0,255,252,0,0,0,0,0,0,0,604,0,0,0,0,0,0,0,252,252,252,252,
253,4604,0,0,906,0,0,0,0,0,0,0,0,0,0,0,0,0,0,253,251,0,0,0,0,0,0,0,0,0,0,0,0,0,0,0,0,0,0,251,255,0,0,0,0,0,0,0,0,0,0,0,0,0,0,0,0,0,0,255,252,252,252,252,252,252,252,252,4906,252,252,252,252,252,252,252,252,252,252,252,
253,604,0,0,906,0,0,0,0,0,0,0,0,0,0,0,0,0,0,253,251,0,0,0,0,0,0,0,0,0,0,0,0,0,0,0,0,0,0,251,255,0,0,0,0,0,0,0,0,0,0,0,0,0,0,0,0,0,0,255,252,0,0,0,0,0,0,0,604,0,0,0,0,0,252,252,252,252,252,252,
253,604,0,0,906,0,0,0,0,0,0,0,0,0,0,0,0,0,0,253,251,0,0,0,0,0,0,0,0,0,0,0,0,0,0,0,0,0,0,251,255,0,0,0,0,0,0,0,0,0,0,0,0,0,0,0,0,0,0,255,252,0,0,0,0,0,0,0,604,0,0,0,0,252,252,252,252,252,252,252,
253,604,0,0,906,0,0,0,0,0,0,0,0,0,0,0,0,0,0,253,251,0,0,0,0,0,0,0,0,0,0,0,0,0,0,0,0,0,0,251,255,0,0,0,0,0,0,0,0,0,0,0,0,0,0,0,0,0,0,255,252,0,0,0,0,0,0,0,604,0,0,0,252,252,252,252,252,252,252,252,
253,604,0,0,906,0,0,0,0,0,0,0,0,0,0,0,0,0,0,0,0,0,0,0,0,0,0,0,0,0,0,0,0,0,0,0,0,0,0,0,0,0,0,0,0,0,0,0,0,0,0,0,0,0,0,0,0,0,0,0,0,0,0,0,0,0,0,0,604,0,0,252,252,252,252,252,252,252,252,252,
253,604,0,0,906,0,0,0,0,0,0,0,0,0,0,0,0,0,0,0,0,0,0,0,0,0,0,0,0,0,0,0,0,0,0,0,0,0,0,0,0,0,0,0,0,0,0,0,0,0,0,0,0,0,0,0,0,0,0,0,0,0,0,0,0,0,0,0,604,0,0,902,0,0,0,2277,2178,0,0,902,
253,253,253,253,253,253,253,253,253,253,253,253,253,253,253,253,253,253,253,253,251,251,251,251,251,251,251,251,251,251,251,251,251,251,251,251,251,251,251,251,255,255,255,255,255,255,255,255,255,255,255,255,255,255,255,255,255,255,255,255,252,252,252,252,252,252,252,252,252,252,252,252,252,252,252,252,252,252,252,252
