251,251,251,251,251,251,251,251,251,251,251,251,251,251,251,251,251,251,251,251,251,251,251,251,251,251,251,251,251,251,4605,251,251,251,251,251,251,251,251,251,251,251,251,251,251,251,251,251,251,251,4604,251,251,251,251,251,251,251,251,251,251,251,251,251,251,251,251,251,251,251,4604,251,251,251,251,251,251,251,251,251,
251,454,454,454,454,454,454,454,454,454,454,454,454,454,0,0,0,0,0,0,251,0,0,0,0,0,251,251,251,0,4605,0,251,251,251,0,0,0,251,0,251,0,0,0,0,0,0,0,0,0,4604,0,0,0,0,0,0,0,0,0,251,0,0,0,4605,251,4605,0,0,0,4604,251,0,0,0,0,251,251,251,251,
251,454,454,454,454,454,454,454,454,454,454,454,454,454,0,0,0,0,0,0,4510,0,0,0,0,0,0,0,0,0,0,0,0,0,0,0,0,0,4510,0,0,0,0,0,0,0,0,0,0,0,4604,0,0,0,0,0,0,0,0,0,0,0,0,0,4605,251,4605,0,0,0,4604,251,6584,0,0,0,0,251,251,251,
251,0,251,251,251,251,251,251,251,251,251,251,251,251,251,251,251,251,251,251,251,251,251,251,251,251,251,251,251,0,4003,0,251,251,251,251,4604,251,251,251,251,251,0,0,0,4604,251,251,251,0,4604,0,251,251,251,0,0,251,4604,251,251,251,251,0,4605,251,4605,251,251,251,4604,251,251,251,0,0,0,0,251,251,
251,454,454,251,251,251,251,251,251,251,251,251,251,251,251,251,251,251,251,251,251,0,6278,0,0,0,251,0,0,0,4604,0,0,251,0,0,4604,251,251,251,251,251,251,0,0,4604,0,251,251,0,4604,0,251,251,0,0,0,251,4604,251,251,4605,0,0,4605,251,4605,251,0,0,4604,251,0,0,0,0,0,0,0,251,
251,454,454,0,0,251,251,251,251,251,251,251,251,251,251,251,251,251,251,251,251,0,0,0,0,0,251,0,0,0,0,0,0,251,0,0,4604,251,251,251,251,251,251,251,0,0,0,0,251,251,251,251,251,0,0,0,0,251,4604,251,251,4605,0,0,4605,251,4605,251,0,0,251,0,0,0,0,0,0,0,0,251,
251,251,251,0,0,251,251,251,251,251,251,251,251,251,251,251,251,251,251,251,251,0,4604,251,251,251,251,0,0,4003,4003,4003,0,251,0,0,4604,251,251,251,251,251,251,251,251,0,0,0,251,251,251,251,251,0,0,0,251,251,4604,251,251,4605,0,0,4605,251,4605,0,0,0,0,0,251,0,4604,251,251,251,251,251,
251,0,454,454,0,251,251,251,251,251,251,251,251,251,251,251,251,251,251,251,251,251,4604,0,251,0,0,0,0,0,0,0,0,0,0,0,0,251,251,251,251,251,251,251,251,251,0,0,0,0,0,0,0,0,0,0,251,251,4604,251,251,4605,0,0,251,251,0,0,251,0,251,251,0,0,4604,0,0,0,0,251,
251,454,454,251,251,251,251,251,251,251,251,251,251,251,251,251,251,251,251,251,251,251,4604,0,0,0,0,251,251,251,251,251,251,251,251,251,251,251,251,251,251,251,251,251,251,251,251,0,0,0,0,0,0,0,0,251,251,251,4604,251,251,4605,0,251,251,0,0,251,0,0,0,0,0,0,4604,0,0,0,0,251,
251,0,251,251,251,251,251,251,251,251,251,251,251,251,251,251,251,251,251,251,251,251,4604,0,0,0,251,0,0,0,0,0,0,0,0,251,251,251,251,251,251,251,251,251,251,251,251,251,0,251,251,251,0,0,251,6277,0,0,4604,251,251,4605,0,0,0,0,0,0,0,0,0,0,0,0,4252,251,251,251,4604,251,
251,454,454,454,0,0,0,0,0,454,454,0,454,454,454,454,454,454,454,0,251,251,4604,0,0,251,251,251,251,251,251,251,251,251,251,251,251,251,251,251,251,251,251,251,251,251,251,251,251,251,251,251,251,251,251,0,0,0,4604,251,251,0,0,0,0,0,0,0,0,251,0,0,0,0,0,0,0,0,4604,251,
251,251,251,251,251,251,251,251,251,251,251,251,251,251,251,251,251,251,604,251,4251,4251,4251,4251,4251,4251,4251,4251,4251,4251,4251,4251,4251,4251,4251,4251,4251,4251,4251,4251,251,251,251,251,251,251,251,251,251,251,251,251,251,251,251,251,251,251,251,251,251,251,251,251,251,251,251,251,251,251,251,251,251,251,251,251,251,251,251,251,
251,251,251,251,251,251,251,251,251,251,251,251,251,251,251,251,251,251,603,251,251,0,0,0,0,0,0,0,0,0,0,0,0,0,0,0,0,0,0,251,251,0,0,0,0,0,0,0,0,0,0,0,0,0,0,0,0,0,0,251,251,0,0,0,0,0,0,0,0,0,0,0,0,0,0,0,0,0,0,251,
251,251,251,251,251,251,251,251,251,251,251,251,251,251,251,251,251,251,603,251,251,0,0,0,0,0,0,0,0,0,0,0,0,0,0,0,0,0,0,251,251,0,0,0,0,0,0,0,0,0,0,0,0,0,0,0,0,0,0,251,251,0,0,0,0,0,0,0,604,0,0,251,251,251,251,251,251,251,604,251,
251,251,251,251,251,251,251,251,251,251,251,251,251,251,251,251,251,251,603,251,251,0,0,0,0,0,0,0,0,0,0,0,0,0,0,0,0,0,0,251,251,0,0,0,0,0,0,0,0,0,0,0,0,0,0,0,0,0,0,0,0,0,251,251,251,0,0,0,604,0,251,605,0,605,605,0,0,0,604,251,
251,251,251,251,251,251,251,251,251,251,251,251,251,251,251,251,251,251,603,251,251,0,0,0,0,0,0,0,0,0,0,0,0,0,0,0,0,0,0,251,251,2583,0,0,0,0,0,0,0,0,0,0,0,0,0,0,0,0,0,0,0,251,605,0,605,0,0,0,604,251,605,605,0,605,605,0,0,0,604,251,
251,251,251,251,251,251,251,251,251,251,251,251,251,251,251,251,251,251,603,251,251,0,0,0,251,251,251,251,251,603,251,251,251,251,251,0,0,0,0,251,251,251,251,251,251,251,251,251,251,251,251,251,251,251,251,251,251,251,251,251,251,0,605,0,605,604,0,0,604,605,605,605,0,605,0,0,0,0,604,251,
251,251,251,251,251,251,251,251,251,251,251,251,251,251,251,251,251,251,603,251,251,0,0,0,605,0,0,0,251,603,251,0,0,0,605,0,0,0,0,251,0,0,0,0,0,0,0,0,0,0,0,0,0,0,0,0,0,0,0,0,251,0,605,0,605,604,0,0,604,605,605,605,0,605,0,0,0,0,604,251,
251,251,251,251,251,251,251,251,251,251,251,251,251,251,251,251,251,251,603,251,251,0,0,0,605,0,0,0,251,603,251,0,0,0,605,0,0,0,0,251,0,0,0,0,0,0,0,0,0,0,0,0,0,0,0,0,0,0,0,0,251,0,605,604,605,604,0,0,604,605,605,605,0,605,0,0,0,0,604,251,
251,251,251,251,251,251,251,251,251,251,251,251,251,251,251,251,251,251,603,251,251,0,0,0,605,0,0,0,251,603,251,0,0,0,605,0,0,0,0,251,251,251,251,251,251,251,251,251,251,251,251,251,251,251,251,251,251,251,251,251,251,0,605,604,605,0,0,0,604,251,605,605,251,605,0,0,0,0,604,251,
251,251,251,251,251,251,251,251,251,251,251,251,251,251,251,251,251,251,603,251,251,0,0,0,605,0,0,0,251,603,251,0,0,0,605,0,0,0,0,251,251,251,251,251,251,251,251,251,251,251,251,251,251,251,251,251,251,251,251,251,251,604,605,604,605,0,0,0,604,251,605,605,251,605,0,0,0,0,604,251,
251,251,251,251,251,251,251,251,251,251,251,251,251,251,251,251,251,251,603,251,251,0,0,0,605,0,0,0,510,603,512,0,0,0,605,0,0,0,0,251,251,251,251,251,251,251,251,251,251,251,251,251,251,251,251,251,251,251,251,251,251,604,0,251,605,0,0,0,604,251,605,605,251,605,0,0,0,0,604,251,
251,251,251,251,251,251,251,251,251,251,251,251,251,251,251,251,251,251,603,251,251,0,0,0,605,2278,0,0,251,603,251,0,2277,2278,605,0,0,0,0,251,251,251,251,251,251,251,251,251,251,251,251,251,251,251,251,251,251,251,251,251,251,604,0,251,605,0,0,0,604,605,605,605,0,605,0,0,0,0,604,251,
251,251,251,251,251,251,251,251,251,251,251,251,251,251,251,251,251,251,603,251,251,251,251,251,251,251,251,251,251,603,251,251,251,251,251,251,251,251,251,251,251,251,251,251,251,251,251,251,251,251,251,251,251,251,251,251,251,251,251,251,251,604,0,251,605,0,0,251,604,605,605,605,0,605,251,251,0,0,604,251,
251,251,251,251,251,251,251,251,251,251,251,251,251,251,251,251,251,251,604,251,251,0,0,0,0,0,0,0,0,604,0,0,0,0,0,0,0,0,0,251,251,251,251,251,251,251,251,251,251,251,251,251,251,251,251,251,251,251,251,251,251,604,0,251,605,0,0,251,604,605,605,0,0,605,605,0,0,0,604,251,
251,0,0,0,0,0,0,0,0,0,0,0,0,0,0,0,0,0,604,251,251,0,0,0,0,0,0,0,0,0,0,0,0,0,0,0,0,0,0,251,251,251,251,251,251,251,251,251,251,251,251,251,251,251,251,251,251,251,251,251,251,604,0,251,605,0,0,251,604,605,605,0,0,0,605,0,0,0,604,251,
251,604,251,251,251,251,251,251,251,251,251,251,251,251,251,251,251,251,604,510,0,0,0,0,0,0,0,0,0,0,0,0,0,0,0,0,0,0,0,0,0,0,0,0,0,0,0,0,0,0,0,0,0,0,0,0,0,0,0,0,0,0,0,251,605,0,604,251,604,605,605,0,0,0,605,0,0,0,604,251,
251,604,0,0,0,0,0,0,0,0,0,0,0,0,0,0,0,251,251,251,201,0,251,0,251,251,0,251,0,251,0,251,0,251,0,251,0,251,0,251,251,251,251,251,251,251,251,251,251,251,251,251,251,251,251,251,251,251,251,251,251,251,0,251,605,251,604,251,604,605,605,0,0,0,605,0,0,0,604,251,
251,251,251,251,251,251,251,251,251,251,251,251,251,251,251,251,0,0,0,251,251,604,0,0,251,0,0,0,0,0,0,0,251,0,0,0,0,0,0,251,0,0,0,0,0,0,0,0,0,0,0,0,0,0,0,0,0,0,0,0,251,0,604,251,0,251,604,251,604,605,605,0,0,0,605,0,0,0,604,251,
251,0,0,0,0,0,0,0,0,0,0,0,0,0,0,251,251,251,604,251,251,604,0,0,0,0,0,0,0,0,0,251,0,0,0,0,0,0,0,251,0,0,0,0,0,0,0,0,0,0,0,0,0,0,0,0,0,0,0,0,251,0,604,251,0,251,604,251,604,605,605,0,0,0,605,0,0,0,604,251,
251,604,251,251,251,251,251,251,251,251,251,251,251,251,0,0,0,0,604,251,251,604,0,0,0,251,0,251,0,0,0,0,0,0,0,0,251,0,0,251,0,0,0,0,0,0,0,0,0,0,0,0,0,0,0,0,0,0,0,0,251,0,604,251,0,251,251,251,604,605,605,0,0,0,605,0,0,0,604,251,
251,604,0,0,0,0,0,0,0,0,2278,0,0,251,251,251,251,251,251,251,251,604,0,0,0,0,0,0,0,0,0,0,251,0,0,0,0,0,0,251,251,251,251,251,251,251,251,251,251,251,251,251,251,251,251,251,251,251,251,251,251,0,604,0,0,0,0,251,604,605,605,0,0,0,605,0,0,0,604,251,
251,604,251,0,0,0,0,0,0,0,251,251,251,251,0,0,0,0,0,251,251,604,0,0,0,0,0,0,251,0,0,0,0,251,0,0,0,0,0,251,251,251,251,251,251,251,251,251,251,251,251,251,251,251,251,251,251,251,251,251,251,0,604,251,251,251,251,251,604,0,605,0,0,0,605,0,0,0,604,251,
251,0,251,251,251,251,251,251,251,251,251,251,251,251,0,0,0,0,0,251,251,604,251,0,0,0,0,0,0,251,251,0,0,0,0,0,0,0,0,251,251,251,251,251,251,251,251,251,251,251,251,251,251,251,251,251,251,251,251,251,251,0,604,0,0,0,0,0,604,0,605,0,0,0,0,0,0,0,604,251,
251,251,251,251,251,251,251,251,251,251,251,251,251,251,251,251,251,251,251,251,251,604,0,0,0,0,251,251,251,251,251,251,251,251,251,0,0,0,0,251,251,251,251,251,251,251,251,251,251,251,251,251,251,251,251,251,251,251,251,251,251,0,0,0,0,0,0,0,604,0,605,0,0,0,0,0,0,0,2277,251,
251,251,251,251,251,251,251,251,251,251,251,251,251,251,251,251,251,251,251,251,251,251,251,251,251,251,251,251,251,251,251,251,251,251,251,251,251,251,251,251,251,251,251,251,251,251,251,251,251,251,251,251,251,251,251,251,251,251,251,251,251,251,251,251,251,251,251,251,604,251,251,251,251,251,251,251,251,251,251,251