0,0,0,0,0,0,0,0,0,0,0,0,0,0,0,0,0,0,0,0,0,0,0,0,0,0,0,0,0,0,0,0,0,0,0,0,0,0,0,0,0,0,254,254,254,254,254,254,254,254,254,254,254,254,254,254,254,254,254,254,251,251,251,251,251,251,251,251,251,251,251,251,251,251,251,251,251,251,251,251,
0,0,254,254,254,0,254,254,0,254,254,0,254,254,254,0,254,0,0,0,255,255,255,255,255,255,255,205,205,205,0,205,205,205,255,255,255,255,255,255,254,0,0,0,0,0,0,0,0,0,0,0,0,0,0,0,0,0,0,0,0,0,0,0,0,0,0,0,0,0,0,0,0,0,0,0,0,0,0,251,
0,0,0,254,0,0,254,0,0,254,0,0,0,254,0,0,0,0,0,0,255,255,0,0,0,0,255,255,255,255,0,255,255,255,255,0,0,0,0,255,254,254,254,254,254,254,254,254,254,254,254,254,254,254,254,254,254,254,254,254,251,0,0,0,0,0,0,0,0,0,0,0,0,0,0,0,0,0,251,251,
0,0,0,254,0,0,254,254,0,254,254,0,0,254,0,0,254,0,0,0,255,255,0,0,0,0,0,255,255,255,0,255,255,255,0,0,0,0,0,255,254,254,254,254,254,254,254,254,254,254,254,254,254,254,254,254,254,254,254,254,251,251,0,0,0,0,0,0,0,0,0,0,0,0,0,0,0,251,251,251,
0,0,0,254,0,0,254,0,0,0,254,0,0,254,0,0,254,0,0,0,255,255,0,0,0,0,0,0,255,255,0,255,255,0,0,0,0,0,0,255,254,0,0,0,0,0,0,0,0,0,0,0,0,0,0,0,0,0,0,254,251,251,251,0,0,0,0,0,0,0,0,0,0,0,0,0,251,251,251,251,
0,0,0,254,0,0,0,905,0,906,0,0,0,254,0,0,254,0,0,0,255,255,0,0,0,0,0,0,0,255,0,255,0,0,0,0,0,0,0,255,254,0,0,0,0,0,0,0,0,0,0,0,0,0,0,0,0,0,0,254,251,251,251,251,0,0,0,0,0,0,0,0,0,0,0,251,251,251,251,251,
0,0,0,0,0,0,0,0,0,0,0,0,0,0,0,0,0,0,0,0,255,255,0,0,0,0,0,0,0,0,0,0,0,0,0,0,0,0,0,255,254,0,0,0,0,0,0,0,0,0,0,0,0,0,0,0,0,0,0,254,251,251,251,251,251,0,0,0,0,0,0,0,0,0,251,251,251,251,251,251,
0,0,0,0,758,758,758,758,758,758,758,758,758,758,0,0,0,0,0,0,255,255,0,0,0,0,0,0,0,0,0,0,0,0,0,0,0,0,0,255,254,0,0,0,0,0,0,0,0,0,0,0,0,0,0,0,0,0,0,254,251,251,251,251,251,251,0,0,0,0,0,0,0,251,251,251,251,251,251,251,
0,0,0,0,1302,0,0,0,0,0,0,0,0,1302,0,0,0,0,0,0,255,255,0,0,0,0,0,0,0,255,0,255,0,0,0,0,0,0,0,255,254,0,0,0,0,0,0,0,0,0,0,0,0,0,0,0,0,0,0,254,251,251,251,251,251,251,251,251,251,251,0,251,251,251,251,251,251,251,251,251,
400,401,402,0,1352,0,0,0,0,905,0,0,0,1352,0,400,401,402,0,0,255,255,0,0,0,0,0,0,255,255,0,255,255,0,0,0,0,0,0,255,254,0,0,0,0,0,0,0,0,0,0,0,0,0,0,0,0,0,0,254,251,251,251,251,251,251,251,251,251,0,0,0,251,251,251,251,251,251,251,251,
450,451,452,0,1402,0,1852,855,1852,857,507,1852,0,1402,0,450,451,452,0,0,255,255,0,0,0,0,0,255,255,255,0,255,255,255,0,0,0,0,0,255,254,0,0,0,0,0,0,0,0,0,0,0,0,0,0,0,0,0,0,254,251,251,251,251,251,251,251,251,251,0,0,0,251,251,251,251,251,251,251,251,
2,3,4,5,6,7,1,2,3,4,5,6,7,1,2,3,4,5,6,7,255,255,255,255,255,255,255,255,255,255,0,255,255,255,255,255,255,255,255,255,254,0,0,0,0,0,0,0,0,0,0,0,0,0,0,0,0,0,0,254,251,251,251,251,251,251,251,251,251,0,0,0,251,251,251,251,251,251,251,251,
252,252,252,252,252,252,252,252,252,252,252,252,252,252,252,252,252,252,252,252,255,255,255,255,255,255,255,255,255,255,0,255,255,255,255,255,255,255,255,255,254,254,254,254,254,254,254,254,254,254,0,254,254,254,254,254,254,254,254,254,251,251,251,251,251,251,251,251,251,251,0,251,251,251,251,251,251,251,251,251,
252,0,0,0,0,0,0,0,0,0,0,0,0,0,0,0,0,0,0,0,255,0,0,0,0,0,255,255,255,0,0,0,255,255,255,0,0,0,255,0,254,0,0,0,0,0,0,0,0,0,0,0,0,0,0,0,0,0,0,0,251,0,0,0,0,251,0,0,0,0,0,251,0,251,0,0,251,251,251,251,
252,0,0,0,0,0,0,0,0,0,0,0,0,0,0,0,0,0,0,0,0,0,0,0,0,0,0,0,0,0,0,0,0,0,0,0,0,0,0,0,0,0,0,0,0,0,0,0,0,0,0,0,0,0,0,0,0,0,0,0,0,0,0,0,0,251,0,0,0,0,0,251,0,905,0,0,0,251,251,251,
252,0,202,202,202,202,202,202,202,202,202,202,202,202,202,202,202,202,202,202,255,255,255,255,255,255,255,255,255,0,758,0,255,255,255,255,0,255,255,255,204,204,0,0,0,0,204,204,204,0,0,0,204,204,204,0,0,204,0,254,201,201,201,0,0,251,0,251,251,251,0,251,251,251,0,0,0,0,251,251,
252,0,0,252,252,252,252,252,252,252,252,252,252,252,252,252,252,252,252,252,255,0,0,0,0,0,255,0,0,0,0,0,0,255,0,0,0,255,255,255,254,254,254,0,0,0,0,254,254,0,0,0,254,254,0,0,0,254,0,254,251,0,0,0,0,251,0,251,0,0,0,251,0,0,0,0,0,0,0,251,
252,0,0,0,0,252,252,252,252,252,252,252,252,252,252,252,252,252,252,252,255,0,0,0,0,0,255,0,0,0,0,0,0,255,0,0,0,255,255,255,254,254,254,254,0,0,0,0,254,1852,254,1852,254,0,0,0,0,254,0,254,251,0,0,0,0,251,0,251,0,0,251,0,0,0,0,0,0,0,0,251,
252,202,202,0,0,252,252,252,252,252,252,252,252,252,252,252,252,252,252,252,255,0,0,255,255,255,255,0,0,758,758,758,0,255,0,0,0,255,255,255,254,254,254,254,254,0,0,0,254,254,254,254,254,0,0,0,254,254,0,254,251,0,0,0,0,251,0,0,0,0,0,0,251,0,0,251,251,251,251,251,
252,0,0,0,0,252,252,252,252,252,252,252,252,252,252,252,252,252,252,252,255,255,0,0,255,0,0,0,0,0,0,0,0,0,0,0,0,255,255,255,254,254,254,254,254,254,0,0,0,0,0,0,0,0,0,0,254,254,0,254,251,0,0,0,251,251,0,0,251,0,251,251,0,0,0,0,0,0,0,251,
252,0,0,202,202,252,252,252,252,252,252,252,252,252,252,252,252,252,252,252,255,255,0,0,0,0,0,255,255,255,255,255,255,255,255,255,255,255,255,255,254,254,254,254,254,254,254,0,0,0,0,0,0,0,0,254,254,254,0,254,251,0,0,251,251,0,0,251,0,0,0,0,0,0,0,0,0,0,0,251,
252,0,202,252,252,252,252,252,252,252,252,252,252,252,252,252,252,252,252,252,255,255,0,0,0,0,255,0,0,0,0,0,0,0,0,255,255,255,255,255,254,254,254,254,254,254,254,254,0,254,254,254,0,0,254,0,0,0,0,254,251,0,0,0,0,0,0,0,0,0,0,0,0,0,251,102,102,102,0,251,
252,0,0,0,0,0,0,0,0,0,0,0,0,0,0,0,0,0,0,252,255,255,0,0,0,255,1850,1851,1852,1852,1852,1852,1852,1852,1851,1850,255,255,255,255,254,254,254,254,254,254,254,254,1852,254,254,254,1852,254,254,0,0,0,0,254,251,0,0,0,0,0,0,0,0,2152,0,0,0,0,0,0,0,0,0,251,
252,202,202,202,202,202,202,202,202,202,202,202,202,202,202,202,202,202,0,252,250,250,250,250,250,250,250,250,250,250,250,250,250,250,250,250,250,250,250,250,254,254,254,254,254,254,254,254,254,254,254,254,254,254,254,254,254,254,254,254,251,251,251,251,251,251,251,251,251,251,251,251,251,251,251,251,251,251,251,251,
252,252,252,252,252,252,252,252,252,252,252,252,252,252,252,252,252,252,0,252,250,0,0,0,0,0,0,0,0,0,0,0,0,0,0,0,0,0,0,250,254,0,0,0,0,0,0,0,0,0,0,0,0,0,0,0,0,0,0,254,251,251,251,251,251,251,251,251,251,251,251,251,251,251,251,251,251,251,251,251,
252,252,252,252,252,252,252,252,252,252,252,252,252,252,252,252,252,252,0,252,250,0,0,0,0,0,0,0,0,0,0,0,0,0,0,0,0,0,0,250,254,0,0,0,0,0,0,0,0,0,0,0,0,0,0,0,0,0,0,254,251,0,0,0,0,0,0,0,0,0,0,0,0,0,0,0,0,0,0,251,
252,252,252,252,252,252,252,252,252,252,252,252,252,252,252,252,252,252,0,252,250,0,0,0,0,0,0,0,0,0,0,0,0,0,0,0,0,0,0,250,254,254,254,0,0,0,0,0,0,0,0,0,0,0,0,0,0,0,0,0,0,0,251,251,251,0,0,0,0,0,251,0,251,0,0,251,251,251,0,251,
252,252,252,252,252,252,252,252,252,252,252,252,252,252,252,252,252,252,0,252,250,0,0,0,0,0,0,0,0,0,0,0,0,0,0,0,0,0,0,250,254,0,906,0,0,0,0,0,0,0,0,0,0,0,0,0,0,0,0,0,0,251,0,0,0,0,0,0,0,251,0,0,0,0,0,0,0,0,0,251,
252,252,252,252,252,252,252,252,252,252,252,252,252,252,252,252,252,252,0,252,250,0,0,0,200,200,200,200,200,0,200,200,200,200,200,0,0,0,0,250,254,204,204,204,204,204,204,204,204,204,204,204,204,204,204,204,204,204,204,204,201,0,0,0,0,0,0,0,0,0,0,0,0,0,251,0,0,0,0,251,
252,252,252,252,252,252,252,252,252,252,252,252,252,252,252,252,252,252,0,252,250,0,0,0,0,0,0,0,250,0,250,0,0,0,0,0,0,0,0,250,0,0,0,0,0,0,0,0,0,0,0,0,0,0,0,0,0,0,0,0,251,0,0,0,0,0,0,0,0,0,0,0,0,0,0,0,0,0,0,251,
252,252,252,252,252,252,252,252,252,252,252,252,252,252,252,252,252,252,0,252,250,0,0,0,0,0,0,0,250,0,250,0,0,0,0,0,0,0,0,250,0,0,0,0,0,0,0,0,0,0,0,0,0,0,0,0,0,0,0,0,251,0,0,0,0,0,0,0,0,0,0,0,0,0,0,0,0,0,0,251,
252,252,252,252,252,252,252,252,252,252,252,252,252,252,252,252,252,252,0,252,250,0,0,0,0,0,0,0,250,0,250,0,0,0,0,0,0,0,0,250,254,254,254,254,254,254,254,254,254,254,254,254,254,254,254,254,254,254,254,254,251,0,0,0,0,0,0,0,0,251,0,0,251,0,0,0,0,0,0,251,
252,252,252,252,252,252,252,252,252,252,252,252,252,252,252,252,252,252,0,252,250,0,0,0,0,0,0,0,250,0,250,0,0,0,0,0,0,0,0,250,254,254,254,254,254,254,254,254,254,254,254,254,254,254,254,254,254,254,254,254,251,0,0,0,0,0,0,0,0,251,0,0,251,0,0,0,0,0,0,251,
252,252,252,252,252,252,252,252,252,252,252,252,252,252,252,252,252,252,0,252,250,0,0,0,0,0,0,0,0,0,0,0,0,0,0,0,0,0,0,250,254,254,254,254,254,254,254,254,254,254,254,254,254,254,254,254,254,254,254,254,251,0,0,251,0,0,0,0,0,251,0,0,251,0,0,0,0,0,0,251,
252,252,252,252,252,252,252,252,252,252,252,252,252,252,252,252,252,252,0,252,250,0,0,0,0,0,0,0,250,0,250,0,0,0,0,0,0,0,0,250,254,254,254,254,254,254,254,254,254,254,254,254,254,254,254,254,254,254,254,254,251,0,0,251,0,0,0,0,0,0,0,0,0,0,0,0,0,0,0,251,
252,252,252,252,252,252,252,252,252,252,252,252,252,252,252,252,252,252,0,252,250,250,250,250,250,250,250,250,250,0,250,250,250,250,250,250,250,250,250,250,254,254,254,254,254,254,254,254,254,254,254,254,254,254,254,254,254,254,254,254,251,0,251,251,0,251,0,251,0,0,0,0,0,0,251,251,0,0,0,251,
252,252,252,252,252,252,252,252,252,252,252,252,252,252,252,252,252,252,0,252,250,250,250,250,250,250,250,250,250,0,250,250,250,250,250,250,250,250,250,250,254,254,254,254,254,254,254,254,254,254,254,254,254,254,254,254,254,254,254,254,251,0,0,251,0,0,0,251,0,0,0,0,0,0,0,0,0,0,0,251,
252,252,252,252,252,252,252,252,252,252,252,252,252,252,252,252,252,252,0,252,250,0,0,0,0,0,0,0,0,0,0,0,0,0,0,0,0,0,0,250,254,254,254,254,254,254,254,254,254,254,254,254,254,254,254,254,254,254,254,254,251,0,0,251,0,0,0,251,0,0,0,0,0,0,0,0,0,0,0,251,
252,0,0,0,0,0,0,0,0,0,0,0,0,0,0,0,0,0,0,0,0,0,0,0,0,0,0,0,0,0,0,0,0,0,0,0,0,0,0,0,0,0,0,0,0,0,0,0,0,0,0,0,0,0,0,0,0,0,0,0,0,0,0,251,0,0,0,251,0,0,0,0,0,0,0,0,0,0,0,251,
252,0,252,252,252,252,252,252,252,252,252,252,252,252,252,252,252,252,252,252,200,0,200,0,200,200,0,200,0,200,0,200,0,200,0,200,0,200,0,200,204,204,204,204,204,204,204,204,204,204,204,204,204,204,204,204,204,204,204,204,201,201,0,251,0,251,0,251,0,0,0,0,0,0,0,0,0,0,0,251,
252,0,0,0,0,0,0,0,0,0,0,0,0,0,0,0,0,0,0,252,250,0,0,0,250,0,0,0,0,0,0,0,250,0,0,0,0,0,0,250,0,0,0,0,0,0,0,0,0,0,0,0,0,0,0,0,0,0,0,0,251,0,0,251,0,251,0,251,0,0,0,0,0,0,0,0,0,0,0,251,
252,252,252,252,252,252,252,252,252,252,252,252,252,252,252,252,252,252,0,252,250,0,0,0,0,0,0,0,0,0,0,250,0,0,0,0,0,0,0,250,0,0,0,0,0,0,0,0,0,0,0,0,0,0,0,0,0,0,0,0,251,0,0,251,0,251,0,251,0,0,0,0,0,0,0,0,0,0,0,251,
252,0,0,0,0,0,0,0,0,0,0,0,0,0,0,0,0,0,0,252,250,0,0,0,0,250,0,250,0,0,0,0,0,0,0,0,250,0,0,250,0,0,0,0,0,0,0,0,0,0,0,0,0,0,0,0,0,0,0,0,251,0,0,251,0,251,251,251,0,0,0,0,0,0,0,0,0,0,0,251,
252,0,252,252,252,252,252,252,252,252,252,252,252,252,252,252,252,252,252,252,250,0,0,0,0,0,0,0,0,0,0,0,250,0,0,0,0,0,0,250,402,402,402,402,402,402,402,402,402,402,402,402,402,402,402,402,402,402,402,402,251,0,0,0,0,0,0,251,0,0,0,0,0,0,0,0,0,0,0,251,
252,0,0,0,0,0,0,0,0,0,0,0,0,252,0,0,0,0,0,252,250,0,0,0,0,0,0,0,250,0,0,0,0,250,0,0,0,0,0,250,402,402,402,402,402,402,402,402,402,402,402,402,402,402,402,402,402,402,402,402,251,0,0,251,251,251,251,251,0,251,0,0,0,0,0,0,0,0,0,251,
252,252,252,252,252,252,252,252,252,252,252,252,252,252,0,0,0,0,0,252,250,0,250,0,0,0,0,0,0,250,250,0,0,0,0,0,0,0,0,250,402,402,402,402,402,402,402,402,402,402,402,402,402,402,402,402,402,402,402,402,251,0,0,0,0,0,0,0,0,251,0,0,0,0,0,0,0,0,0,251,
252,400,400,400,400,400,400,400,400,400,400,400,400,400,400,400,400,400,400,252,250,0,0,0,0,0,250,401,401,401,250,250,250,250,250,0,0,0,0,250,452,452,452,452,452,452,452,452,452,452,452,452,452,452,452,452,452,452,452,452,251,0,0,0,0,0,0,0,0,251,0,0,0,0,0,0,0,0,0,251,
252,450,450,450,450,450,450,450,450,450,450,450,450,450,450,450,450,450,450,252,250,250,250,250,250,250,451,451,451,451,451,451,250,250,250,250,250,250,250,250,452,452,452,452,452,452,452,452,452,452,452,452,452,452,452,452,452,452,452,452,251,251,251,251,251,251,251,401,0,401,251,251,251,251,251,251,251,251,251,251,
252,252,252,252,252,252,252,252,252,252,252,252,252,252,252,252,252,252,252,252,250,250,250,250,250,250,250,250,250,250,250,250,250,250,250,250,250,250,250,250,254,254,254,254,254,254,254,254,254,254,254,254,254,254,254,254,254,254,254,254,251,0,0,0,0,0,0,0,0,0,0,0,0,0,0,0,0,0,0,251,
252,252,507,252,252,252,252,252,252,252,252,252,252,252,252,252,252,252,252,252,250,250,250,250,250,250,250,250,250,250,250,250,250,250,250,250,250,250,250,250,254,0,0,0,0,0,0,0,0,0,0,0,0,0,0,0,0,0,0,254,251,0,0,0,0,0,0,0,0,0,0,0,0,0,0,0,0,0,0,251,
252,252,0,252,252,252,252,252,252,252,252,252,252,252,252,252,252,252,252,252,250,0,0,0,0,0,0,0,0,0,0,0,0,0,0,0,0,0,0,250,254,0,0,0,0,0,0,0,0,0,0,0,0,0,0,0,0,0,0,254,251,0,0,0,0,0,0,0,0,0,0,0,0,0,0,0,0,0,0,251,
252,905,0,905,0,0,0,0,0,0,0,0,0,0,0,0,0,0,0,252,250,0,0,0,0,0,0,0,0,0,0,0,0,0,0,0,0,0,0,250,254,0,0,0,0,0,0,0,0,0,0,0,0,0,0,0,0,0,0,254,251,0,0,0,0,0,0,0,0,0,0,0,0,0,0,0,0,0,0,251,
252,905,0,905,0,0,0,0,0,0,0,0,0,0,0,0,0,0,0,252,250,0,0,0,0,0,0,0,0,0,0,0,0,0,0,0,0,0,0,250,254,0,0,0,0,0,0,0,0,0,0,0,0,0,0,0,0,0,0,254,251,0,0,0,0,0,0,0,0,0,0,0,0,0,0,0,0,0,0,251,
252,905,905,905,0,0,0,0,0,0,0,0,0,0,0,0,0,0,0,252,250,0,0,0,0,0,0,0,0,0,0,0,0,0,0,0,0,0,0,250,254,0,0,0,0,0,0,0,0,0,0,0,0,0,0,0,0,0,0,254,251,0,0,0,0,0,0,0,0,0,0,0,0,0,0,0,0,0,0,251,
252,0,0,0,0,0,0,0,0,0,0,0,0,0,0,0,0,0,0,252,250,0,0,0,0,0,0,0,0,0,0,0,0,0,0,0,0,0,0,250,254,0,0,0,0,0,0,0,0,0,0,0,0,0,0,0,0,0,0,254,251,0,0,0,0,0,0,0,0,0,0,0,0,0,0,0,0,0,0,251,
252,0,0,0,0,0,0,0,0,0,0,0,0,0,0,0,0,0,0,252,250,0,0,0,0,0,0,0,0,0,0,0,0,0,0,0,0,0,0,250,254,0,0,0,0,0,0,0,0,0,0,0,0,0,0,0,0,0,0,254,251,0,0,0,0,0,0,0,0,0,0,0,0,0,0,0,0,0,0,251,
252,0,0,0,0,0,0,0,0,0,0,0,0,0,0,0,0,0,0,252,250,0,0,0,0,0,0,0,0,0,0,0,0,0,0,0,0,0,0,250,254,0,0,0,0,0,0,0,0,0,0,0,0,0,0,0,0,0,0,254,251,0,0,0,0,0,0,0,0,0,0,0,0,0,0,0,0,0,0,251,
252,0,0,0,0,0,0,0,0,0,0,0,0,0,0,0,0,0,0,0,0,0,0,0,0,0,0,0,0,0,0,0,0,0,0,0,0,0,0,0,0,0,0,0,0,0,0,0,0,0,0,0,0,0,0,0,0,0,0,0,0,0,0,0,0,0,0,0,0,0,0,0,0,0,0,0,0,0,0,251,
252,0,0,0,0,0,0,0,0,0,0,0,0,0,0,0,0,0,0,0,0,0,0,0,0,0,0,0,0,0,0,0,0,0,0,0,0,0,0,0,0,0,0,0,0,0,0,0,0,0,0,0,0,0,0,0,0,0,0,0,0,0,0,0,0,0,0,0,0,0,0,0,0,0,0,0,0,0,0,251,
252,252,252,252,252,252,252,252,252,252,252,252,252,252,252,252,252,252,252,252,250,250,250,250,250,250,250,250,250,250,250,250,250,250,250,250,250,250,250,250,254,254,254,254,254,254,254,254,254,254,254,254,254,254,254,254,254,254,254,254,251,251,251,251,251,251,251,251,251,251,251,251,251,251,251,251,251,251,251,251,
