0,0,0,0,0,0,0,0,0,0,0,0,0,0,0,0,0,0,0,0,0,0,0,0,0,0,0,0,0,0,0,0,0,0,0,0,0,0,0,0,0,0,0,0,0,0,0,0,0,0,0,0,0,0,0,0,0,0,0,0,251,251,251,251,251,251,251,251,251,251,251,251,251,251,251,251,251,251,251,251,
0,0,254,254,254,0,254,254,0,254,254,0,254,254,254,0,254,0,0,0,205,205,205,205,205,205,205,205,205,205,205,205,205,205,205,205,205,205,205,205,254,0,0,0,0,0,0,0,0,0,0,0,0,0,0,0,0,0,0,0,0,0,0,0,0,0,0,0,0,0,0,0,0,0,0,0,0,0,0,251,
0,0,0,254,0,0,254,0,0,254,0,0,0,254,0,0,0,0,0,0,255,255,0,0,0,0,0,0,0,0,0,0,0,0,0,0,0,0,0,255,254,254,254,254,254,254,254,254,254,254,254,254,254,254,254,254,254,254,254,254,251,0,0,0,0,0,0,0,0,0,0,0,0,0,0,0,0,0,251,251,
0,0,0,254,0,0,254,254,0,254,254,0,0,254,0,0,254,0,0,0,255,255,0,0,0,0,0,0,0,0,255,0,0,0,0,0,0,0,0,0,0,0,0,0,0,0,0,0,0,0,0,0,0,0,0,0,0,0,0,254,251,251,0,0,0,0,0,0,0,0,0,0,0,0,0,0,0,251,251,251,
0,0,0,254,0,0,254,0,0,0,254,0,0,254,0,0,254,0,0,0,255,255,0,0,0,0,0,0,0,0,0,255,0,0,0,0,0,0,0,0,0,0,0,0,0,0,0,0,0,0,254,0,0,0,0,0,0,0,0,254,251,251,251,0,0,0,0,0,0,0,0,0,0,0,0,0,251,251,251,251,
0,0,0,254,0,0,0,852,855,856,0,0,0,254,0,0,254,0,0,0,255,255,0,255,255,255,255,255,255,255,255,255,255,0,0,0,0,0,0,0,0,0,0,0,0,0,0,0,0,0,254,0,0,0,0,0,0,0,0,254,251,251,251,251,0,0,0,0,0,0,0,0,0,0,0,251,251,251,251,251,
0,0,0,0,0,0,0,0,0,0,0,0,0,0,0,0,0,0,0,0,255,255,0,0,0,0,0,0,0,0,0,255,0,0,0,0,0,0,0,0,0,0,0,0,0,0,0,0,0,0,254,0,0,0,0,0,0,0,0,254,251,251,251,251,251,0,0,0,0,0,0,0,0,0,251,251,251,251,251,251,
0,0,0,0,758,758,758,758,758,758,758,758,758,758,0,0,0,0,0,0,255,255,0,0,0,0,0,0,0,0,255,0,0,0,0,0,0,0,0,0,0,0,0,0,0,0,0,0,254,0,254,0,254,0,0,0,0,0,0,254,251,251,251,251,251,251,0,0,0,0,0,0,0,251,251,251,251,251,251,251,
0,0,0,0,1302,0,902,0,905,0,0,906,0,1302,0,0,0,0,0,0,255,255,0,0,0,0,0,0,0,0,0,0,0,0,0,0,0,0,0,0,0,0,0,0,0,0,0,0,0,254,254,254,0,0,0,0,0,0,0,254,251,251,251,251,251,251,251,251,251,251,0,251,251,251,251,251,251,251,251,251,
400,401,402,0,1352,0,0,0,0,0,0,0,0,1352,0,400,401,402,0,0,255,255,0,0,0,0,0,0,0,0,0,0,0,0,0,0,0,0,0,0,0,0,0,0,0,0,0,0,0,0,254,0,0,0,0,0,0,0,0,254,251,251,251,251,251,251,251,251,251,0,0,0,251,251,251,251,251,251,251,251,
450,451,452,0,1402,0,1852,0,1852,0,507,1852,0,1402,0,450,451,452,0,0,255,255,902,902,902,902,902,902,902,902,902,902,902,902,902,902,902,902,0,0,0,0,0,0,0,0,0,0,0,0,0,0,0,0,0,0,0,0,0,254,251,251,251,251,251,251,251,251,251,0,0,0,251,251,251,251,251,251,251,251,
2,3,4,5,6,7,1,2,3,4,5,6,7,1,2,3,4,5,6,7,255,255,255,255,255,255,255,255,255,255,255,255,255,255,255,255,255,255,255,255,254,254,254,254,254,254,254,254,254,254,0,254,254,254,254,254,254,254,254,254,251,251,251,251,251,251,251,251,251,0,0,0,251,251,251,251,251,251,251,251,
252,252,252,252,252,252,252,252,252,252,252,252,252,252,252,252,252,252,252,252,255,255,255,255,255,255,255,255,255,255,255,255,255,255,255,255,255,255,255,255,254,254,254,254,254,254,254,254,254,254,0,254,254,254,254,254,254,254,254,254,251,251,251,251,251,251,251,251,251,251,0,251,251,251,251,251,251,251,251,251,
252,0,0,0,0,0,0,0,0,0,0,0,0,0,0,0,0,0,0,0,0,0,0,0,0,0,0,0,0,0,0,0,0,0,0,0,0,0,0,0,0,0,0,0,0,0,0,0,0,0,0,0,0,0,0,0,0,0,0,254,251,0,0,0,0,251,0,0,0,0,0,251,0,251,0,0,251,251,251,251,
252,0,0,0,0,0,0,0,0,0,0,0,0,0,0,0,0,0,0,0,0,0,0,0,0,0,0,0,0,0,0,0,0,0,0,0,0,0,0,0,0,0,0,254,254,254,0,254,0,254,0,254,0,254,0,254,254,254,0,254,0,0,0,0,0,251,0,0,0,0,0,251,0,905,0,0,0,251,251,251,
252,0,202,202,202,202,202,202,202,202,202,202,202,202,202,202,202,202,202,202,255,255,255,255,255,255,255,255,255,255,255,255,255,255,255,255,0,0,0,0,0,0,0,0,0,254,0,254,0,254,0,254,254,254,0,254,906,254,0,254,201,201,201,0,0,251,0,251,251,251,0,251,251,251,0,0,0,0,251,251,
252,0,0,252,252,252,0,0,252,252,0,0,0,252,0,0,0,252,252,0,255,0,0,0,0,0,255,0,0,0,0,0,0,255,0,0,0,0,0,0,0,0,0,0,0,254,0,254,0,254,0,254,0,254,0,254,254,254,0,254,251,0,0,0,0,251,0,251,0,0,0,251,251,251,251,0,0,0,0,251,
252,0,0,0,0,252,0,252,252,252,0,252,0,252,0,252,0,252,252,0,255,0,0,0,0,0,255,0,0,0,0,0,0,255,0,0,0,0,0,0,0,0,0,0,0,254,0,254,0,254,0,254,0,254,0,254,0,0,0,254,251,0,0,0,0,251,0,251,0,0,251,0,0,0,0,0,0,0,0,251,
252,202,202,0,0,252,0,252,0,252,0,252,0,252,0,252,0,252,0,0,255,0,0,255,255,255,255,905,905,905,905,0,0,255,0,0,0,255,255,255,254,0,0,254,254,0,0,254,254,254,0,254,0,254,0,254,0,0,0,254,251,0,0,0,0,251,0,251,0,0,0,0,251,251,0,251,251,251,251,251,
252,0,0,0,0,252,0,0,0,252,0,0,0,252,0,0,0,252,0,0,255,255,0,0,0,0,0,0,0,0,0,0,0,0,0,0,0,255,255,255,254,254,0,0,0,0,0,0,0,0,0,0,0,0,0,0,0,0,0,254,251,0,0,0,251,251,0,251,251,251,251,251,0,0,0,0,0,0,0,251,
252,0,0,202,202,252,252,252,252,252,252,252,252,252,252,252,252,252,252,252,255,255,0,0,0,0,0,255,255,255,255,255,255,255,255,255,255,255,255,255,254,254,254,0,0,0,0,0,0,0,0,0,0,0,0,0,0,0,0,254,251,0,0,251,251,0,0,0,0,0,0,0,0,0,0,0,0,0,0,251,
252,0,202,252,252,252,252,252,252,252,252,252,252,252,252,252,252,252,252,252,255,255,0,0,0,0,255,0,0,0,0,0,0,0,0,255,255,255,255,255,254,254,254,254,0,0,0,0,0,0,0,0,0,0,0,0,0,0,0,254,251,0,0,0,0,0,0,0,0,0,0,0,0,0,251,102,102,102,0,251,
252,0,0,0,0,0,0,0,0,0,0,0,0,0,0,0,0,0,0,252,255,255,0,0,0,255,1850,1851,1852,1852,1852,1852,1852,1852,1851,1850,255,255,255,255,254,254,254,254,254,0,0,0,0,0,0,0,0,0,0,0,0,0,0,254,251,0,0,0,0,0,0,0,0,2152,0,0,0,0,0,0,0,0,0,251,
252,202,202,202,202,202,202,202,202,202,202,202,202,202,202,202,202,202,202,252,250,250,250,250,250,250,250,250,250,250,250,250,250,250,250,250,250,250,250,250,254,254,254,254,254,254,254,254,254,254,254,254,254,254,254,254,254,254,254,254,251,251,251,251,251,251,251,251,251,251,251,251,251,251,251,251,251,251,251,251,
252,252,252,252,252,252,252,252,252,252,252,252,252,252,252,252,252,0,0,252,250,0,0,0,0,0,0,0,0,0,0,0,0,0,0,0,0,0,0,250,254,0,0,0,0,0,0,0,0,0,0,0,0,0,0,0,0,0,0,254,251,251,251,251,251,251,251,251,251,251,251,251,251,251,251,251,251,251,251,251,
252,252,252,252,252,252,252,252,252,252,252,252,252,252,252,252,252,252,0,252,250,0,0,0,0,0,0,0,0,0,0,0,0,0,0,0,0,0,0,250,254,0,0,0,0,0,0,0,0,0,0,0,0,0,0,0,0,0,0,254,251,0,0,0,0,0,0,0,0,0,0,0,0,0,0,0,0,0,0,251,
252,252,252,252,252,252,252,252,252,252,252,252,252,252,252,252,252,252,0,252,250,0,0,0,0,0,0,0,0,0,0,0,0,0,0,0,0,0,0,250,254,254,254,0,0,0,0,0,0,0,0,0,0,0,0,0,0,0,0,0,901,0,251,251,251,0,0,0,0,0,251,0,251,0,0,251,251,251,0,251,
252,252,252,252,252,252,252,252,252,252,252,252,252,252,252,252,252,252,0,252,250,0,0,0,0,0,0,0,0,0,0,0,0,0,0,0,0,0,0,250,254,0,906,0,0,0,0,0,0,0,0,0,0,0,0,0,0,0,0,0,901,251,0,0,0,251,251,251,0,251,0,0,0,0,0,0,0,0,0,251,
252,252,252,252,252,252,252,252,252,252,252,252,252,252,252,252,252,252,0,252,250,0,0,0,200,200,200,200,200,0,200,200,200,200,200,0,0,0,0,250,254,204,204,204,204,204,204,204,204,204,204,204,204,204,204,204,204,204,204,204,201,0,0,0,0,0,0,0,0,0,0,0,0,0,251,0,0,0,0,251,
252,252,252,252,252,252,252,252,252,252,252,252,252,252,252,252,252,252,0,252,250,0,0,0,0,0,0,0,250,0,250,0,0,0,0,0,0,0,0,250,0,0,0,0,0,0,0,0,0,0,0,0,0,0,0,0,0,0,0,0,251,0,0,0,0,0,0,0,0,0,0,0,0,0,0,0,0,0,0,251,
252,252,252,252,252,252,252,252,252,252,252,252,252,252,252,252,252,252,0,252,250,0,0,0,0,0,0,0,250,0,250,0,0,0,0,0,0,0,0,250,0,0,0,0,0,0,0,0,0,0,0,0,0,0,0,0,0,0,0,0,251,0,0,0,0,0,0,0,0,0,0,0,0,0,0,0,0,0,0,251,
252,252,252,252,252,252,252,252,252,252,252,252,252,252,252,252,252,252,0,252,250,0,0,0,0,0,0,0,250,0,250,0,0,0,0,0,0,0,0,250,254,254,254,254,254,254,254,254,254,254,254,254,254,254,254,254,254,254,254,254,251,0,0,0,0,0,0,0,0,251,0,0,251,0,0,0,0,0,0,251,
252,252,252,252,252,252,252,252,252,252,252,252,252,252,252,252,252,252,0,252,250,0,0,0,0,0,0,0,250,0,250,0,0,0,0,0,0,0,0,250,254,254,254,254,254,254,254,254,254,254,254,254,254,254,254,254,254,254,254,254,251,0,0,0,0,0,0,0,0,251,0,0,251,0,0,0,0,0,0,251,
252,252,252,252,252,252,252,252,252,252,252,252,252,252,252,252,252,252,0,252,250,0,0,0,0,0,0,0,0,0,0,0,0,0,0,0,0,0,0,250,254,254,254,254,254,254,254,254,254,254,254,254,254,254,254,254,254,254,254,254,251,0,0,251,0,0,0,0,0,251,0,0,251,0,0,0,0,0,0,251,
252,252,252,252,252,252,252,252,252,252,252,252,252,252,252,252,252,252,0,252,250,0,0,0,0,0,0,0,250,0,250,0,0,0,0,0,0,0,0,250,254,254,254,254,254,254,254,254,254,254,254,254,254,254,254,254,254,254,254,254,251,0,0,251,0,0,0,0,0,0,0,0,0,0,0,0,0,0,0,251,
252,252,252,252,252,252,252,252,252,252,252,252,252,252,252,252,252,252,0,252,250,250,250,250,250,250,250,250,250,0,250,250,250,250,250,250,250,250,250,250,254,254,254,254,254,254,254,254,254,254,254,254,254,254,254,254,254,254,254,254,251,0,251,251,0,251,0,251,0,0,0,0,0,0,251,251,0,0,0,251,
252,252,252,252,252,252,252,252,252,252,252,252,252,252,252,252,252,252,0,252,250,250,250,250,250,250,250,250,250,0,250,250,250,250,250,250,250,250,250,250,254,254,254,254,254,254,254,254,254,254,254,254,254,254,254,254,254,254,254,254,251,0,0,251,0,0,0,251,0,0,0,0,0,0,0,0,0,0,0,251,
252,252,252,252,252,252,252,252,252,252,252,252,252,252,252,252,252,252,0,252,250,0,0,0,0,0,0,0,0,0,0,0,0,0,0,0,0,0,0,250,254,254,254,254,254,254,254,254,254,254,254,254,254,254,254,254,254,254,254,254,251,0,901,251,0,0,0,251,0,0,0,0,0,0,0,0,0,0,0,251,
252,0,0,0,0,0,0,0,0,0,0,0,0,0,0,0,0,0,0,0,0,0,0,0,0,0,0,0,0,0,0,0,0,0,0,0,0,0,0,0,0,0,0,0,0,0,0,0,0,0,0,0,0,0,0,0,0,0,0,0,0,0,0,251,0,0,0,251,0,0,0,0,0,0,0,0,0,0,0,251,
252,0,252,252,252,252,252,252,252,252,252,252,252,252,252,252,252,252,252,252,200,0,200,906,200,200,906,200,906,200,906,200,906,200,0,200,906,200,906,200,204,204,204,204,204,204,204,204,204,204,204,204,204,204,204,204,204,204,204,204,201,201,0,251,0,251,0,251,0,0,0,0,0,0,0,0,0,0,0,251,
252,0,0,0,0,0,0,0,0,0,0,0,0,0,0,0,0,0,0,252,250,0,0,0,250,0,0,0,0,0,0,0,250,0,0,0,0,0,0,250,0,0,0,0,0,0,0,0,0,0,0,0,0,0,0,0,0,0,0,0,251,0,0,251,0,251,0,251,0,0,0,0,0,0,0,0,0,0,0,251,
252,252,252,252,252,252,252,252,252,252,252,252,252,252,252,252,252,252,0,252,250,0,0,0,0,0,0,0,0,0,0,250,0,0,0,0,0,0,0,250,0,0,0,0,0,0,0,0,0,0,0,0,0,0,0,0,0,0,0,0,251,0,0,251,0,251,0,251,0,0,0,0,0,0,0,0,0,0,0,251,
252,0,0,0,0,0,0,0,0,0,0,0,0,0,0,0,0,0,0,252,250,0,0,0,0,250,0,250,0,0,0,0,0,0,0,0,250,0,0,250,0,0,0,0,0,0,0,0,0,0,0,0,0,0,0,0,0,0,0,0,251,0,0,251,0,251,251,251,0,0,0,0,0,0,0,0,0,0,0,251,
252,0,252,252,252,252,252,252,252,252,252,252,252,252,252,252,252,252,252,252,250,0,0,0,0,0,0,0,0,0,0,0,250,0,0,0,0,0,0,250,402,402,402,402,402,402,402,402,402,402,402,402,402,402,402,402,402,402,402,402,251,0,0,0,0,0,0,251,0,0,0,0,0,0,0,0,0,0,0,251,
252,0,0,0,0,0,0,0,0,0,0,0,0,252,0,0,0,0,0,252,250,0,0,0,0,0,0,0,250,0,0,0,0,250,0,0,0,0,0,250,402,402,402,402,402,402,402,402,402,402,402,402,402,402,402,402,402,402,402,402,251,0,0,251,251,251,251,251,0,251,0,0,0,0,0,0,0,0,0,251,
252,252,252,252,252,252,252,252,252,252,252,252,252,252,0,0,0,0,0,252,250,0,250,0,0,0,0,0,0,250,250,0,0,0,0,0,0,0,0,250,402,402,402,402,402,402,402,402,402,402,402,402,402,402,402,402,402,402,402,402,251,0,0,0,0,0,0,0,0,251,0,0,0,0,0,0,0,0,0,251,
252,400,400,400,400,400,400,400,400,400,400,400,400,400,400,400,400,400,400,252,250,0,0,0,0,0,250,401,401,401,250,250,250,250,250,0,0,0,0,250,452,452,452,452,452,452,452,452,452,452,452,452,452,452,452,452,452,452,452,452,251,0,0,0,0,0,0,0,0,251,0,0,0,0,0,0,0,0,0,251,
252,450,450,450,450,450,450,450,450,450,450,450,450,450,450,450,450,450,450,252,250,250,250,250,250,250,451,451,451,451,451,451,250,250,250,250,250,250,250,250,452,452,452,452,452,452,452,452,452,452,452,452,452,452,452,452,452,452,452,452,251,251,251,251,251,251,251,401,0,401,251,251,251,251,251,251,251,251,251,251,
252,252,252,252,252,252,252,252,252,252,252,252,252,252,252,252,252,252,252,252,250,250,250,250,250,250,250,250,250,250,250,250,250,250,250,250,250,250,250,250,254,254,254,254,254,254,254,254,254,254,254,254,254,254,254,254,254,254,254,254,251,0,0,0,0,0,0,0,0,0,0,0,0,0,0,0,0,0,0,2326,
252,252,507,252,252,252,252,252,252,252,252,252,252,252,252,252,252,252,252,252,250,250,250,250,250,250,250,250,250,250,250,250,250,250,250,250,250,250,250,250,254,0,0,0,0,0,0,0,0,0,0,0,0,0,0,0,0,0,0,254,251,0,0,0,0,0,0,0,0,0,0,0,0,0,0,0,0,0,0,251,
252,252,2327,252,252,252,252,252,252,252,252,252,252,252,252,252,252,252,252,252,250,0,0,0,0,0,0,0,0,0,0,0,0,0,0,0,0,0,0,250,254,0,0,0,0,0,0,0,0,0,0,0,0,0,0,0,0,0,0,254,251,0,0,0,0,0,0,0,0,0,0,0,0,0,0,0,0,0,251,251,
252,0,0,0,905,0,0,0,0,0,0,0,0,0,0,0,0,0,0,252,250,0,0,0,0,0,0,0,0,0,0,0,0,0,0,0,0,0,0,250,254,0,0,0,0,0,0,0,0,0,0,0,0,0,0,0,0,0,0,254,251,0,0,0,0,0,0,0,0,0,0,0,0,0,0,0,0,251,251,251,
252,0,0,0,905,0,0,0,0,0,0,0,0,0,0,0,0,0,0,252,250,0,0,0,0,0,0,0,0,0,0,0,0,0,0,0,0,0,0,250,254,0,0,0,0,0,0,0,0,0,0,0,0,0,0,0,0,0,0,254,251,0,0,0,0,0,0,0,0,0,0,0,0,0,0,0,251,251,251,251,
252,0,0,0,905,0,0,0,0,0,0,0,0,0,0,0,0,0,0,252,250,0,0,0,0,0,0,0,0,0,0,0,0,0,0,0,0,0,0,250,254,0,0,0,0,0,0,0,0,0,0,0,0,0,0,0,0,0,0,254,251,251,251,251,251,251,251,251,905,251,251,251,251,251,251,251,251,251,251,251,
252,0,0,0,905,0,0,0,0,0,0,0,0,0,0,0,0,0,0,252,250,0,0,0,0,0,0,0,0,0,0,0,0,0,0,0,0,0,0,250,254,0,0,0,0,0,0,0,0,0,0,0,0,0,0,0,0,0,0,254,251,0,0,0,0,0,0,0,0,0,0,0,0,0,251,251,251,251,251,251,
252,0,0,0,905,0,0,0,0,0,0,0,0,0,0,0,0,0,0,252,250,0,0,0,0,0,0,0,0,0,0,0,0,0,0,0,0,0,0,250,254,0,0,0,0,0,0,0,0,0,0,0,0,0,0,0,0,0,0,254,251,0,0,0,0,0,0,0,0,0,0,0,0,251,251,251,251,251,251,251,
252,0,0,0,905,0,0,0,0,0,0,0,0,0,0,0,0,0,0,252,250,0,0,0,0,0,0,0,0,0,0,0,0,0,0,0,0,0,0,250,254,0,0,0,0,0,0,0,0,0,0,0,0,0,0,0,0,0,0,254,251,0,0,0,0,0,0,0,0,0,0,0,251,251,251,251,251,251,251,251,
252,0,0,0,905,0,0,0,0,0,0,0,0,0,0,0,0,0,0,0,0,0,0,0,0,0,0,0,0,0,0,0,0,0,0,0,0,0,0,0,0,0,0,0,0,0,0,0,0,0,0,0,0,0,0,0,0,0,0,0,0,0,0,0,0,0,0,0,0,0,0,251,251,251,251,251,251,251,251,251,
252,0,0,0,905,0,0,0,0,0,0,0,0,0,0,0,0,0,0,0,0,0,0,0,0,0,0,0,0,0,0,0,0,0,0,0,0,0,0,0,0,0,0,0,0,0,0,0,0,0,0,0,0,0,0,0,0,0,0,0,0,0,0,0,0,0,0,0,0,0,0,901,0,0,0,0,2177,0,0,901,
252,252,252,252,252,252,252,252,252,252,252,252,252,252,252,252,252,252,252,252,250,250,250,250,250,250,250,250,250,250,250,250,250,250,250,250,250,250,250,250,254,254,254,254,254,254,254,254,254,254,254,254,254,254,254,254,254,254,254,254,251,251,251,251,251,251,251,251,251,251,251,251,251,251,251,251,251,251,251,251,
